11111111111111111
10P00V00V00C00001
1111V0V1111111111
100E0000000C00001
11111111111111111