1111111111111111111111111111
1P00110100000111100000000011
110000010000000E10000000V001
1100V00100000111000000000001
11000C000000000000C000000001
1111111111111111100000000001
1111111111111111111111111111